...............................
...............................
...............................
.1.............................
.#R#.$..#M#K#A#P#..............
##################.............
..................#.........#1.
...................############