...............................
...............................
...............................
.1.............................
.#R..$..#M.K#A.P#..............
##################.............
..................#..h......#1.
...................############